l l l l l l l l l l l l l l
l a b b b b b 5 b b b b c l
l e f f f f 8 5 f f f f g l
l e f f f f f 5 f f 2 f g l
l e f f f f f 5 f f f f g l
l e f f f f f 5 f f 4 f g l
l e f f f f f 5 f f f f g l
l e f f f f f 5 f f f f g l
l i j j j j j 5 j j j j k l
l l l l l l l l l l l l l l