l l l l l l l l l l l l l l
l a b b b b b b b b b b c l
l e f f f f f f f f f f g l
l e f f f f f f f f f f g l
l e 1 f f f f f f f f 2 g l
l e f f f f f f f f f f g l
l e f f f f f f f f f f g l
l e f f f f f f f f f f g l
l i j j j j j j j j j j k l
l l l l l l l l l l l l l l