l l l l l l l l l l l l l l
l p b b b b b b b b b b o l
l e f f f f f f f f f f g l
l e f f 2 f f f 4 f f f g l
l e f f f f f f f f f f g l
l e f f f f f f f f f f g l
l e f f 6 f f f 8 f f f g l
l e f f f f f f f f f f g l
l m j j j j j j j j j j h l
l l l l l l l l l l l l l ld