l l l l l l l l l l l l l l
l a b b b b b b 1 b b b c l
l e f f f f f f 1 f f f g l
l e f f f f f f 1 f f f g l
l e f f f f f f 1 f f f g l
l e f f f f f f 1 f f f g l
l e f f f f f f 1 f f f g l
l e f f f f f f 1 f f f g l
l i j j j j j j 1 j j j k l
l l l l l l l l l l l l l l