l l l l l l l l l l l l l l
l a b b b b b b 1 3 b b c l
l e f f f f f f 3 1 f f g l
l e f f f f f f 1 3 f f g l
l e f f f f f f 3 1 f f g l
l e f f f f f f 1 3 f f g l
l 7 7 7 7 7 7 7 3 1 f f g l
l e 6 f f f f f 1 3 f f g l
l i j j j j j j 3 1 j j k l
l l l l l l l l l l l l l l